++++++++++++++++++++++++++++1111111111111++++++++
+000000000000000000000000000DDDDDDDD+EEEE00000001
+000000000000000000000000000000000000000000000001
+000000000000000000000000000000000000000000000001
+000000000000000000000000000000000000000000000001
+000000000000000000000000000000000000000000000001
+000000000000000000000000000000000000000000000001
+000000000000000000000000000000000000000000000001
+000000000000000000000000000000000000000000000001
+000000000000000000000000000000000000000000000001
+000000000000000000000000000000000000000000000001
+000000000000000000000000000000000000000000000001
+000000000000000000000000000000000000000000000001
+000000000000000000000000000000000000000000000001
+000000000000000000000000000000000000000000000001
+000000000000000000000000000000000000000000000001
+000000000000000000000000000000000000000000000001
+000000000000000000000000000000000000000000000001
+000000000000000000000000000000000000000000000001
+000000000000000000000000000000000000000000000001
+000000000000000000000000000000000000000000000001
+000000000000000000000000000000000000000000000001
+000000000000000000000000000000000000000000000001
+000000000000000000000000000000000000000000000001
+000000000000000000000000000000000000000000000001
+0000000000000000000000000000000000000000000LKKK+
+0000000000000000000000000000000000000000000L0001
+0000000000000000000000000000000000000000000L0001
+000000000000000000000000000000000000000000L00001
+000000000000000000000000000000000000000000+MMMM+
+000000000000000000000000000000000000000000000001
+000000000000000000000000000000000000000000000001
+000000000000000000000000000000000000000000000001
+000000000000000000000GGGG+0000000000000000000001
+000000000000000000000F000H0000000000000000000001
+000000000000000000000F000H0000000000000000000001
+000000000000000000000F000H0000000000000000000001
+000000000000000000000+000H0000000000000000000001
+00000000000000000000J+000+0000000000000000000001
+0000000000000000000J0F000+I000000000000000000001
+000000000000000000J00F000HII00000000000000000001
+00000000000000000J000F000H0I00000000000000000001
+0000000000000000J0000F000H0II0000000000000000001
+111111111111111+11111+111+11++111111111111111111
