1111111+G+111111111111111111111111
1000AAAB0GGG0000000000000000000001
10AA00+F000GG000000000000000000001
DA0C0B00FFF0GGG0000000000000000001
M00CB000000FFFGGG00000000000000001
MD0+0000000000FF++0000000000000001
+D000000000000EEE++000000000000001
+DD000000EEEEE00000000000000000001
+0D0EEEEE+J00000000000000000000001
+0DH0000I0JJ0000000000000000000001
+00HH000I00JJ000000000000000000001
+000HH00I000JJ00000000000000000001
+0000H00I0000JJ0000000000000000001
+0000HH0I00000JJ000000000000000001
+LLLL0HHI000000JJ00000000000000001
10000LL+LKKKKK00JJ0000000000000001
10000000000000KKKK+000000000000001
1000000000000000000000000000000001
1000000000000000000000000000000001
10000000000+0000000000000000000001
10000000VV+0U000000000000000000001
10000V+V0X000UU0000000000000000001
10NVV0W0+YY0000U000000000000000001
10+00WXX00YYY000U00000000000000001
10+00+0000000YYY0U0000000000000001
10NP00000000000YYYUU00000000000001
10NP0000000000000YYYU0000000000001
10NP000000000000000++Y000000000001
10N0P0000000TTTTTTT000000000000001
10N0PTTTTTTT0000000000000000000001
10N00P0000SR0000000000000000000001
10N00P0000S0R00000000A000000000001
10N000P000S00R00000000A00000000001
10N000P000S00R00000ZZZ+00000000001
10N000P00S0000RZZZZ000A00000000001
10N0000P0S0000ZR000000A00000000001
10N0000P0S00000R000000A00000000001
10+OOOO0PS000000R00000A00000000001
111111+++S+++++11+11++++++++++++++
